#######
#E  # # 
##  # #
#     #
# ##  #
#  ##S#
#######