################
#S  # ##      E#
##  #  ###  ####
#      #    ####
# ##      ######
#      #      ##
################